████████████████████████████████████████████████████
█                      █                           █
█                      █ ███████     ██  ██  ██    █
███████  ████          █ ███████       ██  ██      █
█          ██          █             ██  ██  ██    █
█████  ██████          █████████       ██  ██      █
█          ██          █   █   █                   █
█  ██████████            █ █ █                     █
█          ██          █ █   █ █                   █
█████████  ██          █████████████████████████████
█          ██                               █      █
█████  ██████████████████████████████████   █      █
█                           █   █   █       █      █
█          ███████████  ██      █       █   █      █
█          █             █  █       █   █   █      █
█          █████████████████████████████████████ ███
█                                    █             █
█                       █       █                  █
█ ██████████████████████████████████████████████████
█                                                 @█
████████████████████████████████████████████████████