████████████████████████████████████████████████████
█                      █               __  __      █
█                      █ ███████     ██  ██  ██    █
███████  ████          █ ███████    |  ██  ██  |   █
█          ██          █             ██  ██  ██    █
█████  ██████          █████████    |__██__██__|   █
█          ██          █   █   █                   █
█  ██████████            █ █ █                     █
█          ██          █ █   █ █                   █
█████████  ██          █████████████████████████████
█          ██                              ██      █
█████  ██████████████████████████████████  ██      █
█                           █   █   █       █      █
█          ███████████  ██      █       █   █      █
█          █             █  █       █   █   █      █
█          █████████████████████████████████████ ███
█                                    █             █
█                       █       █                  █
█ ██████████████████████████████████████████████████
█                                                  █
████████████████████████████████████████████████████